A	А
a	а
B	Б
b	б
C	Дж
c	дж
Ç	Ч
ç	ч
D	Д
d	д
E	Э
e	э
F	Ф
f	ф
G	Г
g	г
Ğ	Й
ğ	й
H	Х
h	х
I	Ы
ı	ы
İ	И
i	и
J	Ж
j	ж
K	К
k	к
L	Л
l	л
M	М
m	м
N	Н
n	н
O	О
o	о
Ö	Ё
ö	ё
P	П
p	п
R	Р
r	р
S	С
s	с
Ş	Ш
ş	ш
T	Т
t	т
U	У
u	у
Ü	Ю
ü	ю
V	В
v	в
Y	Й
y	й
Z	З
z	з
X	Кс
x	кс
