ა	ɑ
ბ	b
გ	g
დ	d
ე	ɛ
ვ	v
ზ	z
ჱ	eɪ
თ	t⁽ʰ⁾
ი	i
კ	kʼ
ლ	l
მ	m
ნ	n
ჲ	je
ო	ɔ
პ	pʼ
ჟ	ʒ
რ	r
ს	s
ტ	tʼ
ჳ	uɪ
უ	u
ჷ	ə
ფ	p⁽ʰ⁾
ქ	k⁽ʰ⁾
ღ	ɣ
ყ	qʼ
ჸ	ʔ
შ	ʃ
ჩ	tʃ⁽ʰ⁾
ც	ts⁽ʰ⁾
ძ	dz
წ	tsʼ
ჭ	tʃʼ
ხ	χ
ჴ	q⁽ʰ⁾
ჯ	dʒ
ჰ	h
ჵ	oː
ჶ	f
